####################################
# #  ## ######### # #      #    S# #
# #   #             # #        #   #
#   # ##### ## ###### # #######  # #
### # ##    ##      # # #     #### #
#   # E  #  #######   #   ###    # #
####################################
